type octile
height 16
width 16
map
.....T.....T....
.....T.....T....
.....T.....T....
...........T....
...TTTTT...T....
................
................
.....TTTTT..T...
.....T..T.......
.....T..T.......
.....T..T...TTTT
TTT.............
.......TTT......
................
..T.............
..T.............